00000000000000000000
01116117811111111110
01111111111111111113
01111111111111111110
01111111111111111110
01111111111111111110
01111111111111111110
01111111111111111110
01111111111111111110
00000000040000000000

00000000000000000000
01111111111111111110
51111111111111111110
01111111111111111110
01111111111111111110
01111111111111111110
01111111111111111110
01111111111111111110
01111111111111111110
00000000000040000000

00000000000020000000
01111111111111111110
01111111111111111110
01111111111111111110
01111111111111111110
51111111111111111110
01111111111111111110
01111111111111111110
01111111111111111110
00000000000000000000

00000000020000000000
01111111111111111110
01111111111111111110
01111111111111111110
01111111111111111110
01111111111111111113
01111111111111111110
01111111111111111110
01111111111111111110
00000000000000000000
.